Tile map  < Do not change number of lines >
0  0  0  0  0  0  0  0  0  0  0  0  0  0  0  0  0  0  0  0  0  0  0  0  0  0  0  0  0  0  0  0  0  0  0  0  0  0  0  0  0  0  0  0  0  0  0  0  0  0  0  0  0  0  0  0  0  0  0  0  0  0  0  0  0  0  0  0
0  0  3  3  0  0  0  0  0  0  0  0  0  0  0  0  0  0  0  0  0  0  0  0  0  0  0  0  0  0  0  0  0  0  0  0  0  0  0  0  0  0  0  0  0  0  0  0  0  0  0  0  0  0  0  0  0  0  0  0  0  0  0  0  0  0  0  0
0  0  3  3  3  3  3  3  3  3  3  3  3  0  0  0  0  0  0  0  0  0  0  0  0  0  0  0  0  0  0  0  0  0  0  0  0  0  0  0  0  0  0  0  0  0  0  0  0  0  0  0  0  0  0  0  0  0  0  0  0  0  0  0  0  0  0  0
0  0  3  3  0  0  3  0  0  0  0  0  3  0  0  0  0  0  0  0  0  0  0  0  0  0  0  0  0  0  0  0  0  0  0  0  0  0  0  0  0  0  0  0  0  0  0  0  0  0  0  0  0  0  0  0  0  0  0  0  0  0  0  0  0  0  0  0
0  0  0  0  0  0  3  0  0  0  0  0  3  0  0  0  0  0  0  0  0  0  0  0  0  0  0  0  0  0  0  0  0  0  0  0  0  0  0  0  0  0  0  0  0  0  0  0  0  0  0  0  0  0  0  0  0  0  0  0  0  0  0  0  0  0  0  0
0  0  0  0  0  0  3  3  3  3  3  3  3  0  0  0  0  0  0  0  0  0  0  0  0  0  0  0  0  0  0  0  0  0  0  0  0  0  0  0  0  0  0  0  0  0  0  0  0  0  0  0  0  0  0  0  0  0  0  0  0  0  0  0  0  0  0  0
0  0  0  0  0  0  0  0  0  0  0  0  3  0  0  0  0  0  0  0  0  0  0  0  0  0  0  0  0  0  0  0  0  0  0  0  0  0  0  0  0  0  0  0  0  0  0  0  0  0  0  0  0  0  0  0  0  0  0  0  0  0  0  0  0  0  0  0
0  0  0  0  0  0  0  0  0  0  0  0  3  0  0  0  0  0  0  0  0  0  0  0  0  0  0  0  0  0  0  0  0  0  0  0  0  0  0  0  0  0  0  0  0  0  0  0  0  0  0  0  0  0  0  0  0  0  0  0  0  0  0  0  0  0  0  0
0  0  0  0  0  0  3  3  3  3  3  3  3  3  3  3  3  3  3  0  0  0  0  0  0  0  0  0  0  0  0  0  0  0  0  0  0  0  0  0  0  0  0  0  0  0  0  0  0  0  0  0  0  0  0  0  0  0  0  0  0  0  0  0  0  0  0  0
0  0  0  0  0  0  3  0  0  0  0  0  3  0  0  0  0  0  3  0  0  0  0  0  0  0  0  0  0  0  0  0  0  0  0  0  0  0  0  0  0  0  0  0  0  0  0  0  0  0  0  0  0  0  0  0  0  0  0  0  0  0  0  0  0  0  0  0
0  0  0  0  0  0  3  0  0  0  0  0  3  0  0  0  0  0  3  0  0  0  0  0  0  0  0  0  0  0  0  0  0  0  0  0  0  0  0  0  0  0  0  0  0  0  0  0  0  0  0  0  0  0  0  0  0  0  0  0  0  0  0  0  0  0  0  0
0  0  0  0  0  0  3  0  0  0  0  0  3  0  0  0  0  0  3  0  0  0  0  0  0  0  0  0  0  0  0  0  0  0  0  0  0  0  0  0  0  0  0  0  0  0  0  0  0  0  0  0  0  0  0  0  0  0  0  0  0  0  0  0  0  0  0  0
0  0  0  0  0  0  3  3  3  3  3  3  3  3  3  3  3  3  3  3  3  3  3  3  3  3  3  3  3  3  3  3  3  3  3  3  3  3  3  3  3  3  3  3  3  3  3  3  3  3  3  3  3  3  3  3  3  3  3  0  0  0  0  0  0  0  0  0
0  0  0  0  0  0  3  0  0  0  0  0  0  0  0  0  0  0  3  0  0  0  0  0  0  0  0  0  3  0  0  3  0  0  3  0  0  0  3  0  0  0  0  0  0  0  0  0  0  0  0  3  0  0  0  0  0  0  3  0  0  0  0  0  0  0  0  0
0  0  0  0  0  0  3  0  0  0  0  0  0  0  0  0  0  0  3  0  0  0  0  0  0  0  0  0  3  0  0  0  0  0  3  0  0  0  3  0  0  0  0  0  0  0  0  0 27  3 25  3  0  0  0  0  0  0  3  0  0  0  0  0  0  0  0  0
0 27  3  3 25  0  3  0  0  0  1  1  1  1  0  0  0  0  3  0  0  0  0  1  0  1  1  0  3  0  0  0  0  1  0  1  1  0  3  0  0  0  0  0  0  0  0  0  3  3  3  3  0  0  0  0  0  0  3  0  0  0  0  0  0  0  0  0
0  3  1  1  3  0  3  0  0  0  1  1  1  1  0  0  0  0  3  0  0  0  0  0  3  3  0  3  3  3  0  0  0  0  3  3  0  0  3  0  0  0  0  0  27  3 3 25 24  3 26  3  0  0  0  0  0  0  3  0  0  0  0  0  0  0  0  0
0  3  1  1  3  0  3  0  0  0  1  1  1  1  0  0  0  0  3  0  0  0  0  1  3  3  3  3  0  3  0  0  0  1  3  3  3  3  3  0  0  0  0  0  3  1  1  3  0  3  0  3  0  0  0  0  0  0  3  0  0  0  0  0  0  0  0  0
0 24 16 19  3  3  3  0  0  0  1  1  0  0  0  0  0  0  3  0  0  0  0  0  3  0  0  0  0  3  0  0  0  0  3  0  0  0  3  0  0  0  0  0  3  1  1  3  0  3  0  3  0  0  0  0  0  0  3  0  0  0  0  0  0  0  0  0
0  0  0  0  0  0  3  0  0  0  0 17  0  0  0  0  0  0  3  3  3  3  3  3  3  3  3  3  3  3  3  3  3  3  3  3  3  3  3  3  3  3  3  3  3 16 19  3  3  3  3  3  3  3  3  3  3  3  3  0  0  0  0  0  0  0  0  0
0  0  0  0  0  0  3  0  0  0  0  0  0  0  0  0  0  0  3  0  0  0  0  0  3  0  0  0  0  3  0  0  0  0  3  0  0  0  3  0  0  3  0  0  0  0  0  0  0  0  0  3  0  0  0  0  0  0  3  0  0  0  0  0  0  0  0  0
0  0  0  0  0  0  3  0  0  0  0  0  0  0  0  0  0  0  3  0  0  0  0  0  3  0  0  0  0  3  0  0  0  0  3  0  0  0  3  0  0  3  0  0  0  0  0  0  0  0  0  3  0  0  0  0  0  0  3  0  0  0  0  0  0  0  0  0
0  0  0  0  0  0  3  0  0  0  1  1  1  1  0  0  0  0  3  0  1  1  1  1  3  1  1  1  1  3  1  1  1  1  3  0  0  0  3  0  0  3  0  0  0  0 27  3 25  0  0  3  3  3  3  0  0  0  3  0  0  0  0  0  0  0  0  0
0  0 27  3 25  0  3  0  0  0  1  1  1  1  0  0  0  0  3  0  1  1  1  1  3  1  1  1  1  3  1  1  1  1  3  0  0  0  3  0  0 27 25  0  0  0  3  3  3  3  3  3  0  0 27 25  0  0  3  0  0  0  0  0  0  0  0  0
0  0  3  3  3  0  3  0  0  0  1  1  1  1  0  0  0  0  3  0  0 16 19  0  3  0 16 19  0  3  0 16 19  0  3  0  0  0  3  0  0 24 26  0  0  0 24  3 26  0  0  3  0  0 24 26  0  0  3  0  0  0  0  0  0  0  0  0
0  0 24  3 26  0  3  0  0  0  1  1  0  0  0  0  0  0  3  0  0 16 19  0  3  0 16 19  0  3  0 16 19  0  3  0  0  0  3  0  0  0  0  0  0  0  0  0  0  0  0  3  0  0  0  0  0  0  3  0  0  0  0  0  0  0  0  0
0  0  0  3  0  0  3  0  0  0  0 17  0  0  0  0  0  0  3  0  0 16 19  0  3  0 16 19  0  3  0 16 19  0  3  0  0  0  3  0  0  0  0  0  0  0  0  0  0  0  0  3  0  0  0  0  0  0  3  0  0  0  0  0  0  0  0  0
0  0  0  3  3  3  3  3  3  3  3  3  3  3  3  3  3  3  3  3  3  3  3  3  3  3  3  3  3  3  3  3  3  3  3  3  3  3  3  3  3  3  3  3  3  3  3  3  3  3  3  3  3  3  3  3  3  0  3  0  0  0  0  0  0  0  0  0
0  0  0  0  0  3  3  0  0  0  0  0  0  0  0  0  0  0  3  0  0  0  0  0  0  0  0  0  0  1  1 16  3  0  0  1  1  0  3  0  0  0  0  0  0 27  3 25  0  0  0  3  0 27  3 25  3  0  3  0  0  0  0  0  0  0  0  0
0  0  0  0  0  0  3  0  0  0  0  0  0  0  0  0  0  0  3  0  0  0  0  0  0  0  0  0  0  1  1  0  3  0  0  1  1 16  3  0 27  3 25  0  0  3  3  3  3  3  3  3  0  3  3  3  3  0  3  0  0  0  0  0  0  0  0  0
0  0 27  1 25  3  3  0 27  1 25  0  0  0  0  0  0  0  3  0  0  0  0  0  0  0  0  0  0  1  1  0  3  0  0  1  1  0  3  0  3  3  3  0  0 24  3 26  0  0  3  0  0 24  3 26  3  0  3  0  0  0  0  0  0  0  0  0
0  0  1  1  1  3  3  0  1  1  1  0  0  0  0  0  0  0  3  0  0  0  0  0  0  0  0  0  0  0  0  0  3  0  0  0  0  0  3  0 24  3 26  0  0  0  3  0  0  0  3  3  3  3  3  3  3  0  3  0  0  0  0  0  0  0  0  0
0  0  1  1  1  3  0  0  1  1  1  0  0  0  0  0  0  0  3  0  0  0  0  0  0  0  0  0  0  0  0  0  3  0  0  1  1  0  3  3  3  3  0  0  0  0  0  0  0  0  3  0  0  0  0  0  0  0  3  0  0  0  0  0  0  0  0  0
0  0  1  1  1 16  0  0  1  1  1 16  3  0  0  0  0  0  3  0  0  0  0  0  0  0  0  0  0  1  1 16  3  0  0  1  1 16  3  0  0  0  0  0  0  0  0 27  3 25  3  0  0  0  0  0  0  0  3  0  0  0  0  0  0  0  0  0
0  0 24  1 26  3  0  0 24  1 26  0  3  0  0  0  0  0  3  0  0  0  0  0  0  0  0  0  0  1  1  0  3  0  0  1  1  0  3  0 27  3 25  0  0  0  0  3  3  3  3  0 27  3 25  0  0  0  3  0  0  0  0  0  0 27 25  0
0  0  0  0  0  3  0  0  0  0  0  0  3  0  0  0  0  0  3  0  0  0  0  0  0  0  0  0  0  1  1  0  3  0  0  0  0  0  3  0  3  3  3  0  0  0  0 24  3 26  3  0  3  3  3  0  0  0  3  0  0  0  0  0  0 24 26  0
0  0 27  1 25  3  0  0 27  1 25  0  3  0  0  0  0  0  3  0  0  0  0  0  0  0  0  0  0  0  0  0  3  0  0  1  1  0  3  0 24  3 26  0  0  0  0  0  3  0  3  0 24  3 26  0  0  0  3  0  0  0  0  0  0 16 19  0
0  0  1  1  1  3  0  0  1  1  1  0  3  0  0  0  0  0  3  0  0  0  0  0  0  0  0  0  0  0  0  0  3  0  0  1  1 16  3  0  0  3  0  0 27  3 25  0  3  0  3  0  0  3  0  0  0  0  3  0  0  0  0  0  0  0  0  0
0  0  1  1  1  3  0  0  1  1  1  0  3  0  0  0  0  0  3  0  0  0  0  0  0  0  0  0  0  1  1 16  3  0  0  1  1  0  3  3  3  3  0  0  3  3  3  3  3  0  3  0  0  3  0  0  0  0  3  0  0  0  0  0  0  0  0  0
0  0  1  1  1 16  0  0  1  1  1 16  3  0  0  0  0  0  3  0  0  0  0  0  0  0  0  0  0  1  1  0  3  0  0  0  0  0  3  0  0  0  0  0 24  3 26  0  3  3  3  3  3  3  0  0  0  0  3  0  0  0  0  0  0  0  0  0
0  0 24  1 26  3  3  0 27  1 26  0  3  0  0  0  0  2  2  2  0  0  0  0  0  0  0  0  0  1  1  0  3  0  0  0  0  0  3  0  0  0  0  0  0  0  0  0  0  0  0  3  0  0  0  0  0  0  3  0  0  0  0  0  0  0  0  0
0  0  0  0  0  0  3  3  3  3  3  3  3  3  3  3  3  2  0  2  3  3  3  3  3  3  3  3  3  3  3  3  3  3  3  3  3  3  3  3  3  3  3  3  3  3  3  3  3  3  3  3  3  3  3  3  3  3  3  0  0  0  0  0  0  0  0  0
0  0  0  0  0  0  3  0  0  0  0  0  0  0  0  0  3  2  2  2  3  0  0  0  0  0  0  0  0  0  0  0  3  0  0  1  1  0  3  0  0  0  0  0  0  0  0  0  0  0  0  3  0  0  0  0  0  0  3  0  0  0  0  0  0  0  0  0
0  0  0  0  0  0  3  0  0  0  0  0  0  0  0  0  3  3  3  3  3  0  0  0  0  0  0  0  0  1  1 16  3  0  0  1  1 16  3  0  0  0  0  0  0  0  0  0  0  0  0  3  0  0  0  0  0  0  3  0  0  0  0  0  0  0  0  0
0 27  3  3 25  0  3  0  0  0  0  0  0  0  0  0  0  0  3  0  0  0  0  0  0  0  0  0  0  1  1  0  3  0  0  1  1  0  3  0  0  0  0  0 27  3  3 25  0 27 25  3  0  0 27 25  0  0  3  0  0  0  0  0  0  0  0  0
0  3  1  1  3  0  3  0  0  0  0  0  0  0  0  0  0  0  3  0  0  0  0  0  0  0  0  0  0  1  1  0  3  0  0  0  0  0  3  0  0  0  0  0  3  1  1  3  0 24 26  3  0  0 24 26  0  0  3  0  0  0  0  0  0  0  0  0
0  3  1  1  3  0  3  0  0  0  0  0  0  0  0  0  0  0  3  0  0  0  0  0  0  0  0  0  0  0  0  0  3  0  0  1  1  0  3  0  0  0  0  0  3  1  1  3  0  0  0  3  0  0  0  0  0  0  3  0  0  0  0  0  0  0  0  0
0 24 16 19  3  3  3  0  0  0  0  0  0  0  0  0  0  0  3  0  0  0  0  0  0  0  0  0  0  1  1 16  3  0  0  1  1 16  3  3  3  3  3  3  3 16 19  3  3  3  3  3  3  3  3  3  3  3  3  0  0  0  0  0  0  0  0  0
0  0  0  0  0  0  0  0  0  0  0  0  0  0  0  0  0  0  3  0  0  0  0  0  0  0  0  0  0  1  1  0  0  0  0  1  1  0  0  0  0  0  0  0  0  0  0  0  0  0  0  0  0  0  0  0  0  0  0  0  0  0  0  0  0  0  0  0
0  0  0  0  0  0  0  0  0  0  0  0  0  0  0  0  0  0  0  0  0  0  0  0  0  0  0  0  0  1  1  0  0  0  0  0  0  0  0  0  0  0  0  0  0  0  0  0  0  0  0  0  0  0  0  0  0  0  0  0  0  0  0  0  0  0  0  0

Object map, 0=empty, 1=Tree0, 2=Tree1, 3=Fence8, 4=Fence12, 5=Fence14, 6=Fence10, 7=Water
4  7  7  7  7  7  7  7  7  7  7  7  7  7  7  7  7  7  7  7  7  7  7  7  7  7  7  7  7  7  7  7  7  7  7  7  7  7  7  7  7  7  7  7  7  7  7  7  7  7  7  7  7  7  7  7  7  7  7  7  7  7  7  7  7  7  7  5
8 16  0  0  0  0  0  1  0  0  0  0  0  0  0  0  0  0  1  0  0  0  0  0  0  0  0  0  0  0  0  0  0  0  0  0  0  0  0  0  0  0  0  0  0  0  0  0  0  0  0  0  0  0  0  0  0  0  0  0  0  0  0  0  0  0  0 10
8  0  0  0  0  0  0  0  0  0  0  0  0  0  0  0  0  0  0  0  0  0  0  0  0  0  0  0  1  0  0  0  0  0  0  0  0  0  0  0  0  0  0  0  0  0  0  0  1  0  0  0  0  0  0  0  0  0  0  0  0  2  0  0  0 16  0 10
8 16  0  0  0  0  0  0  0  0  0  0  0  0  0  0  0  0  0  0  0  0  0  0  0  0  0  0  0  0  0  0  1  0  1  0  0  0  0 16  0  0  0  2  0  0  0  0  1  0  0  0  0  0  0  0 16  0  0  0  0  0  0  0  0  0  0 10
8  0  0  0  0  0  0  0  0  0  0  0  0  0  0  0  0  0  0  0  0  0  0  0  0  0  0  0  0  0  0  0  0  0  0  0  0  0  0  0  0  0  0  0  0  0  0  0  0  0  0  0  0  2  0  0  0  1  0  0  0  0  0  0  0  0  0 10
8  0  0  0  0  0  0  0  0  0  0  0  0  0  0  0  0  0  0  0  0 16  0  0  0  0  1  0  0  0  0  0  0  0  0  0  0  0  0  1  0  0  0  0  0  0  0  0  0  0  0  0  0  0  0  0  0  0  0  0  0  0  0  0  1  0  0 10
1  1  1  1  1  48 50 50 45 16 1 16  0 16  1 16 48 50 50 45  0  0  0  0  2  0  0  0  0  0  0  0  0  0  0  0  0  0  0  0  0  0  0  0  0  0  0 16  0  0  0  0  0  0  0  0  0  0  0  0  0  0  0  0  0  0  0 10
16 1  0  16 1  49 0  0  47 50 50 50 0 50 50 50 46  0  0 49  0  0  0  0  0  0  0  0  0  0  0  1  0  0  0  2  0  0  0  0  0  0  0  0  1  0  0  0  0  0  0  0  0  0  0  0  0  0  0  0  1  0  0  0  0  0  0 10
1  0  2  0  1  49 0  0  0  0  0  0  0  0  0  0  0  0  0 49  0  0  0  1  0  0  0  0  0  0  0  0  0  0  0  0  0  0  0  0  1  0  0  0  0  0  0  0  0  0  0  0  0  2  0  0  0  0  0 16  0  0  0  2  0  0  0 10
16 0  1  0 16  49 0  0  1  0  0  0  0  0  0  0  0  0  0 49  0  0  0  0  0  0  0  0  1  0  0  0  0  0  0  0  0  0  0  0  0  0  0  0  0  0  0  0  1  0  0  0  0  0  0  0  0  0  0  0  0  0  0  0  0  0  0 10
48 50 50 50 50 46 0  0  0  1  0  2  0  0  0  1  0  0  0 47 50 50 50 50 50 50 50 50 50 50 50 50 50 50 50 50 50 50 50 50 50 50 50 50 50 50 50 50 50 50 50 50 50 50 50 50 50 50 50 45  1  1  1  1  1  1  1  1
49 0  0  0  0  0  0  0  0  0  0  0  0  0  0  0  0  0  0  0  0  0  2  0  0 16  0  0  1  0  1  0  0  2  1  0  2  0  1  0  0 16  0  0  2  0  1  0  2  0  0 16  0  1  0  1  0  0  0 49  0  0  0  0  1  0  0  0
49 0  0  0  0  0  0  0  0  0  0  0  0  0  0  0  0  0  0  0  0  0  0  0  0  0  0  0  0  0  0  0  0  0  0  0  0  0  0  0  0  0  0  0  0  0  0  0  0  0  0  0  0  0  0  0  0  0  0 49  0  0  0  0  1  0  1  0
49 50 50 50 50 45 0  4  7  7  7  7  7  7  7  7  7  5  0  4  7  0  7  7  0  7  7  0  0  8  7  7  7  7  0  7  7  0  0 48 50 50 50 50 50 50 50 50 50 50 50  0 50 50 50 50 50 45  0 49  0  1  0  1  0  0 16  0
49 0  0  0  0  49 0  8  0  1  0  0  0  0  0  0  0  0  0  8  1  0  0 35  0 36 36  0  0  8  1  0  0 35  0 36 36  0  0 49  1  0  0  0  0 14  0  1 65 66 66  0  0  0 16  0  1 49  0 49  0  0  0  0  0  0  1  0
49 0  0  0  0  49 0  8  0  0 33 34 34 34 34  0  1  0  0  8  0  0  0 36  0  0 36  0  0  8  0  0  0 36  0  0 36  0  0 49  0  0  1  0  0  0  0  2 66 66 66  0  0  1  0  0  0 49  0 49  0  0 16  0  0  1  0  1
49 0 31 32  0  49 0  8  0  0 34 34 34 34 34  0 13  0  0  8  1  0  0  0  1  0 36  0  0  8  1  0  0  0  1  0 36  0  0 49  0  0  0  0  0  0  0  0 66 66 66  0  0  0  0 16  0 49  0 49  0  1  0  0  0  0  0  0
49 0 32 32  0  49 0  8  0  0 34 34 34 34 34  0 13  0  0  8  1  1  0 36  0  0  0  0  0  8  1  1  0 36  0  0  0  0  0 49 16  0  0  0  0 31 32  0  0  0  0  0  0 16 16  1  0 49  0 49  0  0  0  0  0 16  0  0
49 0  0  0  0  0  0  8  0  0 34 34 34 34 34  0  1  0  0  6  9  9  9 36  0  0  0  0  0  6  9  9  9 36  0  0  0  0  0 49  0  0  0  0  0 32 32  0  0  0  0  0  0  0 16  0  0 49  0 49  0  1  0  0  0  1  0  1
49 0  0  0  0  0  0  6  9 16  0  0  0  0  0  0  0  0  0  0  0  0  0  0  0  0  0  0  0  0  0  0  0  0  0  0  0  0  0  0  0  0  0  0  0  0  0  0  0  0  0  0  0  0  0  0  0  0  0 49  0  0  0  1  0  0  0  0
49 0  0  0  0  0  0  0  0  0  0  0  0  0  0  0  0  0  0  0  0  0  0  0  0  0  0  0  0  0  0  0  0  0  0  7  7  5  0 49  0  0  0  0  0  0  0  0  0  0  0  0  0  0  0  0  0 49  0 49  0  0  0  1  0 16  0  0
49 16 1  2  0  0  0  4  7  7  7  7  7  7  7  0  0  0  0  0  0  0  0  0  0  0  0  0  0  0  0  0  0 16  0  0  0 10  0 49  0  0  0  0  0  4  7  7  7  0  0  0  1  1  1  1  0 49  0 49  0  1  0 16  0  0  0  0
49 4  7  7  7  7  0  8  0  0 33 34 34 34 34  0  1  0  0  8 25 26 26 26  0 25 26 26 26  0 25 26 26 26  0  0  1 10  0 49  0  0  0  0  0  1 59 60 60  0  0  0  0  0  0  0  0 49  0 49  0  0  0  0  1  1  0  1
49 1 65 66 66  0  0  8  0  0 34 34 34 34 34  0 13  0  0  0 26 26 26 26  0 26 26 26 26  0 26 26 26 26  0  0  2 10  0 49  0 61 62  0  0  1 60 60 60  0  0  0  2  0 61 62  0 49  0 49  0  1  0  1  1  0 16  0
49 2 66 66 66  0  0  8  0  0 34 34 34 34 34  0 13  0  0  8 26 26 26 26  0 26 26 26 26  0 26 26 26 26  0  0  0 10  0 49  2 62 62  0  0  1 60 60 60  0  0  0 16  1 62 62  0 49  0 49  0  1  0  0  0  0  1  0
49 1 66 66 66  0  0  8  0  0 34 34 34 34 34  0  1  0  0  8  0  0  0  0  0  0  0  0  0  0  0  0  0  0  0  0 13 10  0 49 16  1  0  0  0  1  1  0  0  0  0  0  0  0  0  0  0 49  0 49  0  0  0 16  0  0  0  0
49 0  0  0  0  0  0  6  9 16  0  0  0  0  0  0  0  0  0  6  9  0  0  0  0  0  0  0  0  0  0  0  0  0  0  9  9  3  0 47 50 50 50 50 50 50 50 50 50 50 50  0 50 50 50 50 50 45  0 49  0  1  0  0  0  0  0  0
49 0  0  0  0  0  0  0  0  0  0  0  0  0  0  0  0  0  0  0  0  0  0  0  0  0  0  0  0  0  0  0  0  0  0  0  0  0  0  0  0  0  0  0  0  0  0  0  0  0  0  0  0  0  0  0  0 49  0 49  0  0  1  1  0  0 16  0
49 4  7  7  7  7  0  4  7  7  7  7  7  7  7  7  7  5  0  4  7  7  7  7  7  0  8  0 23 24 24  0  0  8 20 21 21  0  0  4  7  7  7  0  0 63 64 64 14  0  0  0  2 63 64 64  0 49  0 49  0  1  0  0  0  1  0  1
49 8  0  0  0  0  0  8  0  0  0  0 51 52 52 52 16 10  0  8 16  0  0  0  0  0  8  0 24 24 24  0  0  8 21 21 21  0  0 16 57 58 58  0  1 64 64 64  0  0  0  0  1 64 64 64  0 49  0 49  0  0  0  0  0 16  0  0
49 8 28 28 28  0  1  8 28 28 28  0 52 52 52 52  0 10  0  8  0  0  0  0  0  0  8  0 24 24 24  0  0  8 21 21 21  0  0  0 58 58 58  0 16 64 64 64  0  0  0  0 16 64 64 64  0 49  0 47 45  1  16 0  0  0  0  1
49 8 27 28 28  0  0  8 27 28 28  0 52 52 52 52  0 10  0  8  0  0  0  0  0  0  8  1  0  2  1  0  0  8 21 21 21  0  0  1 58 58 58  0  0  0  0  0  0  0  0  0  0  0  0  0  0 49  0 16 49  0  0  0  1  0 16  0
49 0 28 28 28  0  0  0 28 28 28  0 52 52 52 52  0 10  0  8  0  0 19  0  0  0  8  1  0  2  1  0  0  8 20 21 21  0  0  0  0  0  0  0  0 13  4  7  7  7  0  0  0  0  0  0  0 49  0  1 49  1  1  1  1  1  1  1
1  0 28 28 28  0  1  0 28 28 28  0  0  0  0  0  0 10  0  8  0  0  0  0  0  0  8  0 23 24 24  0  0  8 21 21 21  0  0  4  7  7  7  0  0  0  8 53 54 54  0  4  7  7  7  1  0 49  0 16 47 50 50 50 50 50 50 45
49 8 28 28 28  0  0  8 28 28 28  0  0  0  0  0  0 10  0  8  0  0  0  0  0  0  8  0 24 24 24  0  0  8 21 21 21  0  0  1 59 60 60  0  0 12  1 54 54 54  0 16 55 56 56  1  0 49  0  0  0  0  0  0 16 86 87 49
49 8  0  0  0  0  0  0  0  0  0  0  0  0  0  0 16 10  0  8 16  0  0  0  0 17  8  0 24 24 24  0  0  8 21 21 21  0  0  1 60 60 60  0  0  0  8 54 54 54  0  1 56 56 56  1  0 49  0 16 49  0  0  0  1 87 87 49
49 8 28 28 28  0  0  0 28 28 28  0  0  1  7  7  7  3  0  6  7  7  7  1  0  0  8  1  0  2  1  0  0  8 20 21 21  0  0  1 60 60 60  0  0  0  0  0  0  0  0  1 56 56 56  1  0 49  0  1 49  0  0  1  1  0  0 49
49 8 27 28 28  0  1  0 27 28 28  0  0  1  2  0  0  0  0  0  0  0  2  1  0  0  8  1  0  2  1  0  0  8 21 21 21  0  0  1  1  0  0  0 63 64 64  0  0  0  0  0  0  0  0  0  0 49  0 16 49  1  0  1  1  0  0 49
0  0 28 28 28  0  0  0 28 28 28  0  0  1  2  0 11  0  0  0 11  0  2  1  0  0  8  0 23 24 24  0  0  8 21 21 21  0  0  0  0  0  0  1 64 64 64  0  0  0  0  0  0  0  0  0  0 49  0 48 46  0  0  1  1  0  0 49
1  0 28 28 28  0  1  0 28 28 28  0  0  1  2  0  0  0  0  0  0  0  2  1  0  0  8  0 24 24 24  0  0  8 21 21 21  0  0  0  0  0  0 16 64 64 64  0  0  0  0  0  0  0  0  0 14 49  0 49  0  1  0  0  0  0  0 49
49 0 28 28 28  0  0  8 28 28 28  0  0  1  2  0  0  0  0  0  0  0  2  1  0  0  4  9 24 24 24  0  0  0  0  0  0 22  0  0 50 50 50 50 50 50 50 50 50 50 50  0 50 50 50 50 50 46  0 49  0  0  0  0  1  0  0 49
49 7  7  7  7  7  0  0  0  0  0  0  0  0  0  0  0  0 18  0  0  0  0  0  0  0  0  0  0  0  0  0  0  0  0  0  0  0  0  0  0  0  0  0  0  0  0  0  0  0  0  0  0  0  0  0  0  0  0 49  0  0  8 19 10  0  0 49
49 1 16  1  0  0  0  1  0  0  0  0  0  1  2  0  0  0  0  0  0  0  2  1  0  0  0  0  0  0  0  0  0  8 20 21 21  0  0 48 50 50 50 50 50 50 50 50 50 50 50  0 50 50 50 50 50 45  0 49  0  0  6  9  3  0  0 49
49 50 50 50 50 45 0  1 51 52 52 52  0  1  2  0  0  0  0  0  0  0  2  1  0  0  4  9 23 24 24  0  0  8 21 21 21  0  0 49 12  0  1  0  0  0  0  0 16  0  0  0  0  0  0  0  0 49  0 49  0  0  0  0  0  0  2 49
49 0  0  0  0  49 0  1 52 52 52 52  0  1  2  0  0  0  0  0  0  0  2  1  0  0  8  0 24 24 24  0  0  8 21 21 21  0  0 49  0  0  0  0  0  0  0  0  0 61 62  0  2  0 61 62  0 49  0 49  0 16  0  1  0  0  0 49
49 0 29 30  0  49 0  0 52 52 52 52  0  1  2  0 11  0  0  0 11  0  2  1  0  0  8  0 24 24 24  0  0  8 21 21 21  0  0 49  0 16  0  0  0 29 30  0  1 62 62  0 16  1 62 62  0 49  0 49  0 51 52 52 52  0  0 49
49 0 30 30  0  49 0  1 52 52 52 52  0  1  9  9  9  9  0  9  9  9  1  1  0  0  8  0  0  0 16  0  0  8 20 21 21  0  0 49  0  0  0  0  0 30 30  0  0  0  0  0  0  0  0  0  0 49  0 49  0 52 52 52 52  0  0 49
49 0  0  0  0  0  0  0  0  0  0  0  0  0  0  0  0  0  0  0  0  0  0  0  0  0  8  0 23 24 24  0  0  8 21 21 21  0  0  0  0  0  0  0  0  0  0  0  0  0  0  0  0  0  0  0  0  0  0 49  0 52 52 52 52  0  0 49
49 1  0  0  0  0  0  0  0  0  0  0  0  0  0  0  0  0  0  0  0  0  0  0  0 17  8  0 24 24 24  0  0  8 21 21 21  0  0 49  0  0  0  1  0  0  0  0  0  2  0  0  0  1  0  0  0  0 14 49  0 52 52 52 52  0  0 49
47 50 50 50 50 50 50 50 50 50 50 50 50 50 50 50 50 50 50 50 50 50 50 50 50 50 6  9 24 24 24  9  9  3 21 21 21  9  9 47 50 50 50 50 50 50 50 50 50 50 50 50 50 50 50 50 50 50 50 46 50 50 50 50 50 50 50 46